11111111111111111111
10000100000000100001
10000100000000100001
10000100001111100001
10000100000000100001
10000100000000100001
10000101000000100001
10000000000000111001
10000001100000000001
10000000100011110001
10000000100000000001
10000000100110000001
10111000100000001111
10000000100000000001
11111111111111111111
