11111111111111111111
10000100000000100001
10000100000000100001
10000100000000100001
10000100000000100001
10000100000000100001
10000101000000100001
10000000000000100001
10000001100000000001
10000000100000000001
10000000100000000001
10000000100000000001
10000000100000000001
10000000100000000001
11111111111111111111
