0101010101010101010101010101010101010101
0100000000010000000000000000010000000001
0100000000010000000000000000010000000001
0100000000010000000001010101010000000001
0100000000010000000000000000010000000001
0100000000010000000000000000010000000001
0100000000010001000000000000010000000001
0100000000000000000000000000010101000001
0100000000000001010000000000000000000001
0100000000000000010000000101010100000001
0100000000000000010000000000000000000001
0100000000000000010000010100000000000001
0100010101000000010000000000000001010101
0100000000000000010000000000000000000001
0101010101010101010101010101010101010101
